type octile
height 4
width 4
map
@@@@
@..@
@..@
@@@@
